11111111111111111111111111111111
10000000000000000000000000000001
10000000000000000000000000000001
10000000000000000000000000000001
10000000000000000000000000000001
10000000000000000000000000000001
10000000000000000000000000000001
10000000000000000000000000000001
10000000000111111000000000000001
10000000000000001000000000000001
10000000000000001000000000000001
10000000000000001000000000000001
10000000000000001000000000000001
10000000000000000000000000000001
10000000000000000000000000000001
10000000000000000000000000000001
10000000000000000000000001111111
10000000000000000000000000000001
10000000000000000000111100000001
10000000000000000000000000000001
10000000000000111100000000000001
10000000001000000000000000000001
1P000000111100000000000000000001
11111111111111111111111111111111