1111111111111111111111111111111111111
1000000000000000000000000000000000001
1000000000000b00000000000000000000001
1000011111000000000000111111000000001
1000010000000000000000100000000000001
1000010000000000000000100000000b00001
1000010000000000000000100000000000001
1000000000000000000000100000000000001
1000000000000000000000100000000000001
1000000000000000000000100000000000001
10000B000000000000P000000000000000001
1000000000000000000000000000000000001
1000000000000000000000000001000000001
1000010000000000000000000001000000001
1000010000000000000000000001000b00001
1000010000000000000000000001000000001
1000010000000000000000000001000000001
1000010000000000000000000001000000001
10000100b0000000111111111111000000001
1000000000000000000000000000000000001
1000000000000000000000000000000000001
1111111111111111111111111111111111111