11111111111111111111111111111111
10000000000000000000000000000001
10000000000000000000000000000001
10000111000000000000001100000001
1000000000000w000000000000000001
10000000000000000000000000h00001
1000000000w00000w000000011111001
1000000000000W000000000000000001
10000000000111111000000000000001
10000000000000001000000000000001
1000h000000000001000000000000001
10011100000000001000110000000001
10000000000000001000000000000001
10000000000000000000000001110001
10000000011100000000000000000001
100000000000000000000000000000c1
100000h0000000000000000001111111
10001111111100000000000000000001
10000000000000000000111100000001
10000000000000000000000000000001
10000000000000111100000000000001
10000000001000000000000000000001
100000001111000000c000000000P001
11111111111111111111111111111111