1111111111111111111111111111111111111111
1000000000000000000000000000000000000001
1000000000000000000000000000000000000001
1000000000000000000000000000000000000001
1000000000000000000000000000000000000001
1000000000000000000000000000000000000001
1000000000000000000000000000000000000001
1000000000000000000000000000000000000001
1000000000000000000000000000000000000001
1000000000000000000000000000000000000001
1000000000000000000100000000000000000001
1000000000000000000100000000000000000001
1000000000000000000100000000000000000001
1000000000000000000100000000000000000001
1000000000001111111111111111111000000001
1000000000000000000100000000000000000001
1000000000000000000100000000000000000001
1000000000000000000100000000000000000001
1000000000000000000100000000000000000001
1000000000000000000100000000000011000001
1000000000000000000000000000000000000001
1000000000000000000000000000000000000001
100000000P000000000000000001100000000001
1000000000000000000000000000000000000001
1000000000000000000000110000000000000001
1000000000000000000000000000000000000001
1000000000000000011000000000000000000001
1000000000000000000000000000000000000001
1000000000000000000000000000000000000001
1111111111111111111111111111111111111111