1111111111111111111111111111111111111
1000000000000000000000000000000000001
1000000000000000000000000000000000001
1000011111000000000000111111000000001
1000010000000000000000100000000000001
1000010000000000000000100000000000001
1000010000000000000000100000000000001
1000000000000000000000100000000000001
1000000011111111000000100000000000001
1000000000000001000000100000000000001
100000000000000100P000000000000000001
1000000000000001000000000000000000001
1000000000000001000000000001000000001
1000010000000001000000000001000000001
1000010000000000000000000001000000001
1000010000000000000000000001000000001
1000010000000000000000000001000000001
1000010000000000000000000001000000001
1000010000000000111111111111000000001
1000000000000000000000000000000000001
1000000000000000000000000000000000001
1111111111111111111111111111111111111